....................
.........C..........
........###.....CC..
................##..
...CCC........SS....
...###........##....
....................
.........CCC........
.........###........
....................
....CCC.......CCC...
....###.......###...
....................
.1.............X....
####################