.....SC.............
.....##.............
....................
.SS......CC..S......
.##......###########
.....#..............
........#...........
.CC.SSSS............
##############......
..................#.
S.C.S...........CC..
#######........#####
....................
.1...C.......S.X....
####################