....................
....................
....................
.SS......CC.........
.##......###########
....................
....##........CS....
..............##....
........##..........
..............#.....
..C..SS.........CC..
##########.....#####
....................
.1...C.....S...X....
####################