.............CS.....
.............##.....
....................
.SS......CC..S......
.##......###########
.....#..............
....................
........#...........
...........###......
....................
S.C.S...........CC..
##########.....#####
....................
.1...C.......S.X....
####################