....................
..C......C..........
..#.....###.....CC..
................##..
...........S........
...###.....#........
....................
..C.....CC..........
..#.................
....................
....CCS.......CSC...
....###.......###...
....................
.1.............X....
####################