....................
...SC.....S....X....
...##.....#....#....
....................
...CCC......#.......
...###...S..........
.........##.........
..C........#........
..#............#....
.....SC..........CS.
.....##......#..###.
..........#.........
.1......#...........
####################