....................
...C.....C..........
...#.....C...C..CC..
.....C...#......##..
.....#..............
........C...........
........#.....C.....
..............#.....
......C.............
......#.............
....C.........CCC...
....#.........###...
....................
.1................X.
####################