....................
................C...
................#.CC
.S...C...CCCCS....CC
.#...C...###########
.....#..............
....................
.CC.SSSSCCCCCC....C.
##############....#.
....................
..C............CCCCC
...............#####
....................
.1CCCCCCSS.C.S...X..
####################