....................
...C.....C...C......
...#.....C...C..C...
.....C...#......#...
.....#..............
........C.........C.
........#.....C.....
...C..........#.....
......C...........C.
......#....C........
....C.........C#....
....#...............
....................
.1.......C........X.
####################