....................
.........C.....C....
........###....#....
....................
...CCC.....S........
...##......#...S....
.......#.......#....
..C.......CC........
..#.......##........
.....SC..........C..
.....##.........###.
..........#.........
....................
.1.............X....
####################