....................
...C.....C...C......
...#.....C...C..C...
.....C...#......#...
.S...#..............
.#......C.........C.
........#.....C.....
...C..........#.....
......C...........C.
......#....C........
....C.........C#....
....#...............
....................
.1...S...C..SS....X.
####################