....................
.X.......C.....CS...
.#......###....##...
....................
...SCC........#.....
...###..............
...........#........
..C.......CCSSCC....
..#.......######....
.....SC.............
.....##.......C.....
..........#.........
.1..................
####################