....................
.C......C......CS...
...............##...
....#.....C.........
...SCC........#.....
...###..............
...........#.....C..
..C....C............
..#..........C......
.....SC.........SSC.
.....##.........###.
..........#.........
.1................X.
####################