....................
.........C..........
........###.....CC..
................##..
...CCC..............
...###..............
....................
.........CCC........
.........###........
....................
....CCC.......CCC...
....###.......###...
....................
.1.............X....
####################