....................
.........C..........
.........C...#..CC..
.........#......##..
...CCC..............
...###..C...........
........#.........C.
..........CC......#.
......C...##........
......#.............
....C.........CCC...
....#.........###...
....................
.1................X.
####################