....................
.........C..........
.........C...#..CC..
.........#......##..
...SCC..............
...###..C...........
........#.........C.
..........CC......#.
......C...##........
......#.............
....C.........CSC...
....#.........###...
....................
.1................X.
####################