....................
................C...
................#...
.S.......CC..S......
.#.......###########
.....#..............
....................
.CC.SSSS............
##############......
..................#.
..C.............CC..
...............#####
....................
.1...C..SS.C.S...X..
####################