....................
.X......CCC....CS...
.#......###....##...
..............C.....
...SCC.....C..#.....
...###.....#......#.
....................
..C.......CCSSCC....
..#.......######....
.....SC.............
.....##...C.........
..........#..CCCCC..
...............#....
.1..................
####################