...............C....
.C..C...C......CS...
....#...#......##...
..........C.........
...SCC........#.....
...###..............
...........#.....C..
..C....C............
..#..........C......
.....SC.........SSC.
.....##.....#...###.
..........C.........
..........#.........
.1CCCCCCCC.CCCCCCCX.
####################